The Maze:
+- -+---+---+---+---+---+---+---+---+---+---+
|                                       |   |
+   +   +---+---+---+---+---+---+---+   +   +
|   |           |       |               |   |
+   +---+---+   +---+   +   +---+---+---+   +
|   |           |       |   |   |           |
+---+   +---+---+   +---+   +   +   +---+   +
|       |           |       |   |   |       |
+   +---+   +---+---+   +---+   +   +   +---+
|       |   |           |           |       |
+---+---+   +   +---+---+---+---+   +---+   +
|           |       |           |       |   |
+   +   +---+---+   +---+   +   +---+---+   +
|   |           |           |               |
+   +---+   +---+---+---+---+---+---+---+   +
|       |                                   |
+---+---+---+---+---+---+---+---+---+---+- -+

Solution found!
+-*-+---+---+---+---+---+---+---+---+---+---+
| * * * * * * * * * * * * * * * * * * * |   |
+   +   +---+---+---+---+---+---+---+ * +   +
|   |           |       | * * * * * * * |   |
+   +---+---+   +---+   + * +---+---+---+   +
|   |           |       | * |   |           |
+---+   +---+---+   +---+ * +   +   +---+   +
|       |           | * * * |   |   |       |
+   +---+   +---+---+ * +---+   +   +   +---+
|       |   | * * * * * |           |       |
+---+---+   + * +---+---+---+---+   +---+   +
|           | * * * |     * * * |       |   |
+   +   +---+---+ * +---+ * + * +---+---+   +
|   |           | * * * * * | * * * * * * * |
+   +---+   +---+---+---+---+---+---+---+ * +
|       |                                 * |
+---+---+---+---+---+---+---+---+---+---+-*-+