22 8
+- -+---+---+---+---+---+---+---+---+---+---+
|                                       |   |
+   +   +---+---+---+---+---+---+---+   +   +
|   |           |       |               |   |
+   +---+---+   +---+   +   +---+---+---+   +
|   |           |       |   |   |           |
+---+   +---+---+   +---+   +   +   +---+   +
|       |           |       |   |   |       |
+   +---+   +---+---+   +---+   +   +   +---+
|       |   |           |           |       |
+---+---+   +   +---+---+---+---+   +---+   +
|           |       |           |       |   |
+   +   +---+---+   +---+   +   +---+---+   +
|   |           |           |               |
+   +---+   +---+---+---+---+---+---+---+   +
|       |                                   |
+---+---+---+---+---+---+---+---+---+---+- -+